#################################__________________________________________________________________________________#________________________________________________________________________________________________________________________________________________________________________________________________
#################################____________333333_________________________________________________________________#_______________________________________________________________________________________________________________________________________________________________
###############################_#_________________________________________________________3__________________________#______________________________________________________________________________________________________________________________________________________________
______________________#_________#____________________###____333333333333333333333333333333____________________________#_____________________________________________________________________________________________________________________________________________________________
______________________#__@_$____#____________3___________________3___________________________________######____________#____________________________________________________________________________________________________________________________________________________________
______________________#######___#______________3________________________________________________________________________#___________________________________________________________________________________________________________________________________________________________
______________________#_________#+________________________###______###_____3_____________________________________________#__________________________________________________________________________________________________________________________________________________________
______________________#_________##________________3________________________________________###______3_____________________#_________________________________________________________________________________________________________________________________________________________
______________________#_________######______________3____3333___33333333333333333333333333333333333333333333_###___________#________________________________________________________________________________________________________________________________________________________
______________________#_________#__________###_______________333333333333333333333333333__________3333333333_____3333_______#_______________________________________________________________________________________________________________________________________________________
______________________#__****_$_#_33_____________###########_____3333333333333333333_____########____________________________#______________________________________________________________________________________________________________________________________________________
______________________#_________#_33_###___#_____________________33333333333333333333_33_______________3333333333333333333____#_____________________________________________________________________________________________________________________________________________________
______________________#_________#_33______________###______####___3______________________________####__________________________#____________________________________________________________________________________________________________________________________________________
______________________#_________#_33_____##_______3__________________________###__j_____________________________________________#___________________________________________________________________________________________________________________________________________________
______________________#_________#_33____####_______###____________j_________########__________________________________j__________#__________________________________________________________________________________________________________________________________________________
______________________#_________#_33_________________________#######____3___________________________________######________________#_________________________________________________________________________________________________________________________________________________
______________________#_________#_33___________###___###____###_______________###_________#######_____###__________________________#________________________________________________________________________________________________________________________________________________
______________________#****$_***#_33___####______________________###________________________________________________________________#_______________________________________________________________________________________________________________________________________________
______________________#_________#_33________###______333________________###_____________###_____3______________j_____________________#______________________________________________________________________________________________________________________________________________
______________________#_________#_3333______3_________________####_____________j_______________________________________3333___________#_____________________________________________________________________________________________________________________________________________
______________________#_________#_333333___________##_______________________####_________________________#########___________#____________________________________________________________________________________________________________________________________________
______________________#_________#______________________j______j_________________________________________________________________________#___________________________________________________________________________________________________________________________________________
______________________#_________#_____________________###________________$__________##_______###_________________________________________#__________________________________________________________________________________________________________________________________________
______________________#_________#________________________________####____####_____________j_______________________________________________#_________________________________________________________________________________________________________________________________________
______________________#_________#____________________3_j_____###_______________________#######__________________j__________________________#________________________________________________________________________________________________________________________________________
______________________#*$_******#__________________________________________j_____###___________________###_#________________________________#_______________________________________________________________________________________________________________________________________
______________________#_________#_______________________####____________333_______________333_____________________________j__________________#______________________________________________________________________________________________________________________________________
______________________#_________#____________3333________________###_____________####___j_________________________j___________________________#_____________________________________________________________________________________________________________________________________
______________________#_________#_______________________________________###__j_$________###____________________________________________________#______________________________________________________________________________________________________________________________________________
______________________#_________#___________________________________________####_______________________j____3333333333333333333333______________#___________________________________________________________________________________________________________________________________
______________________#_________#_____________j_____________________________________j_______####_________________________________________________#__________________________________________________________________________________________________________________________________
______________________#_________#_________j________j______________________________________________________________________________________________#_________________________________________________________________________________________________________________________________
______________________#_________#_________________________________#___________####____j_____________j______________________________________________#________________________________________________________________________________________________________________________________
______________________#*****_$_*##_________________________________________________j___####___________________j__________j__________________________#_______________________________________________________________________________________________________________________________
______________________#______$__________j___________________j________________________________________________________________________________________#______________________________________________________________________________________________________________________________
______________________#______$________________________________________________________________________________________________________________________#_____________________________________________________________________________________________________________________________
______________________#____________________________j_______________j_______________________j_______j_______j___________________j______________________##____________________________________________________________________________________________________________________________
______________________################################################################################################################################______________________________________________________________________________________________________________________________
____________________________________________________________________________________________________________________________________________________________________________________________________________________________________________________________________________________
____________________________________________________________________________________________________________________________________________________________________________________________________________________________________________________________________________________
____________________________________________________________________________________________________________________________________________________________________________________________________________________________________________________________________________________
____________________________________________________________________________________________________________________________________________________________________________________________________________________________________________________________________________________
____________________________________________________________________________________________________________________________________________________________________________________________________________________________________________________________________________________
____________________________________________________________________________________________________________________________________________________________________________________________________________________________________________________________________________________
____________________________________________________________________________________________________________________________________________________________________________________________________________________________________________________________________________________
____________________________________________________________________________________________________________________________________________________________________________________________________________________________________________________________________________________
____________________________________________________________________________________________________________________________________________________________________________________________________________________________________________________________________________________
____________________________________________________________________________________________________________________________________________________________________________________________________________________________________________________________________________________
